acar	açar
acara	açara
acarda	açarda
acardan	açardan
acarlar	açarlar
aci	acı,açı
acili	acılı
acililik	acılılık
acilim	açılım
adali	adalı
adalilik	adalılık
adas	adaş
adasa	adaşa
adci	adcı
adcilik	adcılık
adil	adıl
adim	adım
adli	adlı
adlilik	adlılık
adsiz	adsız
adsizlik	adsızlık
afis	afiş
afise	afişe
afisi	afişi
afisin	afişin
afisinde	afişinde
afisine	afişine
afisini	afişini
afisler	afişler
afisleri	afişleri
afislerin	afişlerin
afisli	afişli
afislik	afişlik
aga	ağa
ahir	ahır
ahira	ahıra
ahirli	Ahırlı
ahsa	ahşa
aki	akı
akidan	akıdan
akil	akıl
akilci	akılcı
akilcilik	akılcılık
akilli	akıllı
akillilik	akıllılık
akillim	akıllım
akilsiz	akılsız
akilsizlik	akılsızlık
akim	akım
akimci	akımcı
akimli	akımlı
akimsiz	akımsız
akis	akış
akisli	akışlı
akissiz	akışsız
akli	aklı
akliselim	aklıselim
akliselime	aklıselime
aksam	akşam
aksama	akşama
aksamda	akşamda
aksamdan	akşamdan
aksamlamak	akşamlamak
aksamlar	akşamlar
aksin	akşın
aku	akü
alic	alıç
alici	alıcı
alicilik	alıcılık
alim	alım
alimci	alımcı
alimli	alımlı
alimlilik	alımlılık
alimsiz	alımsız
alin	alın
alindi	alındı
alis	alış
almac	almaç
almas	almaş
almasa	almaşa
amac	amaç
anac	anaç
anali	analı
ani	anı
anilik	anılık
anlayalim!	anlayalım!
arac	araç,Araç
ari	arı
arici	arıcı
aricilik	arıcılık
arilik	arılık
ariz	arız
ariza	arıza
arizada	arızada
arizadan	arızadan
arizalanma	arızalanma
arizalanmadan	arızalanmadan
arizalanmak	arızalanmak
arizalanmalar	arızalanmalar
arizalar	arızalar
ars	arş
arsa	arşa
arsin	arşın
arti	artı
asabilme	aşabilme
asabilmek	aşabilmek
asabilmeleri	aşabilmeleri
asabilmeli	aşabilmeli
asabilmesi	aşabilmesi
asama	aşama
asamadan	aşamadan
asamalar	aşamalar
asar	aşar
asara	aşara
asarda	aşarda
asardan	aşardan
asarlar	aşarlar
asi	ası,aşı
asici	aşıcı
asil	asıl
asili	asılı,aşılı
asililik	aşılılık
asilli	asıllı
asillik	asıllık
asilsiz	asılsız
asim	asım,aşım
asinim	aşınım
asisiz	aşısız
asit	aşıt
ask	aşk
aska	aşka
aske	aşke
asklar	aşklar
aslanim!	aslanım!
asma	aşma
asmada	aşmada
asmadan	aşmadan
asmak	aşmak
asmalar	aşmalar
atas	ataş
atasa	ataşa
ates	ateş
ates!	ateş!
atesi	ateşi
atesin	ateşin
atesinde	ateşinde
atesinden	ateşinden
atesine	ateşine
atesini	ateşini
atesinin	ateşinin
atici	atıcı
aticilik	atıcılık
atik	atık
atili	atılı
atilim	atılım
atim	atım
avuc	avuç
avunc	avunç
ayca	ayça
aycada	ayçada
aycadan	ayçadan
ayin	ayın
ayni	aynı
aynilik	aynılık
aynisi	aynısı
ayrac	ayraç
ayriyeten	ayrıyeten
azi	azı
babac	babaç
bac	baç
baca	baça
bag	bağ
bag-fiil	bağ-fiil
bag-fiila	bağ-fiila
bag-fiilci	bağ-fiilci
bag-fiilcu	bağ-fiilcu
bag-fiilda	bağ-fiilda
bag-fiildan	bağ-fiildan
bag-fiilde	bağ-fiilde
bag-fiilden	bağ-fiilden
bag-fiile	bağ-fiile
bag-fiili	bağ-fiili
bag-fiilin	bağ-fiilin
bag-fiilina	bağ-fiilina
bag-fiilinda	bağ-fiilinda
bag-fiilinde	bağ-fiilinde
bag-fiiline	bağ-fiiline
bag-fiilini	bağ-fiilini
bag-fiilinu	bağ-fiilinu
bag-fiillar	bağ-fiillar
bag-fiillari	bağ-fiillari
bag-fiillarin	bağ-fiillarin
bag-fiiller	bağ-fiiller
bag-fiilleri	bağ-fiilleri
bag-fiillerin	bağ-fiillerin
bag-fiilli	bağ-fiilli
bag-fiillik	bağ-fiillik
bag-fiillu	bağ-fiillu
bag-fiilluk	bağ-fiilluk
bag-fiilsi	bağ-fiilsi
bag-fiilsiz	bağ-fiilsiz
bag-fiilsu	bağ-fiilsu
bag-fiilsuz	bağ-fiilsuz
bag-fiilun	bağ-fiilun
baga	bağa
bagcik	bağcık
bagcilik	bağcılık
bagit	bağıt
bagitli	bağıtlı
baglanmak	bağlanmak
bahsedebilme	bahşedebilme
bahsedebilmek	bahşedebilmek
bahsedebilmeleri	bahşedebilmeleri
bahsedebilmeli	bahşedebilmeli
bahsedebilmesi	bahşedebilmesi
bahsetme	bahşetme
bahsetmede	bahşetmede
bahsetmeden	bahşetmeden
bahsetmek	bahşetmek
bahsetmeleri	bahşetmeleri
bahsetmelerin	bahşetmelerin
bahsetmeli	bahşetmeli
bahsetmesi	bahşetmesi
bahsettirme	bahşettirme
bahsettirmek	bahşettirmek
bakac	bakaç
baki	bakı
bakici	bakıcı
bakicilik	bakıcılık
bakim	bakım
bakindi	bakındı
bakir	bakır
bakirci	bakırcı
bakircilik	bakırcılık
bakirimsi	bakırımsı
bakirli	bakırlı
bakirsi	bakırsı
barca	barça
barcada	barçada
barcadan	barçadan
barcalar	barçalar
bari	barı
baris	barış
bas	baş
basa	başa
basak	başak,Başak
basaka	başaka
basaklama	başaklama
basaklamak	başaklamak
basaklanma	başaklanma
basari	başarı
basarili	başarılı
basarim	başarım
basarisiz	başarısız
basarisizlik	başarısızlık
basi	bası
basili	basılı
baslama	başlama
baslama!	başlama!
baslamada	başlamada
baslamadan	başlamadan
baslamak	başlamak
baslamalar	başlamalar
baslanma	başlanma
baslanmadan	başlanmadan
baslanmak	başlanmak
baslar	başlar
baslatabilme	başlatabilme
baslatabilmek	başlatabilmek
baslatabilmeleri	başlatabilmeleri
baslatabilmesi	başlatabilmesi
baslatma	başlatma
baslatmada	başlatmada
baslatmadan	başlatmadan
baslatmak	başlatmak
baslatmalar	başlatmalar
baslayabilme	başlayabilme
baslayabilmek	başlayabilmek
baslayabilmeleri	başlayabilmeleri
baslayabilmesi	başlayabilmesi
basmak	başmak
basta	başta
bastalar	baştalar
bastan	baştan
bastanlar	baştanlar
bastarda	baştarda
basyayla	Başyayla
bati	batı,Batı
batici	Batıcı
baticilik	Batıcılık
batik	batık
batili	Batılı
batililik	Batılılık
batin	batın
batini	batıni
batinin	batınin
batis	batış
bayati	bayatı
bayindir	bayındır,Bayındır
bazali	bazalı
bazi	bazı
beceris	beceriş
becerisi	becerişi
becerisin	becerişin
becerisinde	becerişinde
becerisine	becerişine
becerisini	becerişini
belese	beleşe
belirtec	belirteç
benzesen	benzeşen
benzesene	benzeşene
benzesim	benzeşim
bes	beş
besi	beşi
besin	beşin
besinci	beşinci
besincide	beşincide
besinciler	beşinciler
besincilerin	beşincilerin
besincilik	beşincilik
besincisi	beşincisi
besinde	beşinde
besine	beşine
besini	beşini
besleme	beşleme
beslemeci	beşlemeci
beslemede	beşlemede
beslemeden	beşlemeden
beslemek	beşlemek
beslemeler	beşlemeler
beslemeleri	beşlemeleri
beslemelerin	beşlemelerin
beslemeli	beşlemeli
beslemesi	beşlemesi
besler	beşler
bicik	bıçık
bicim	biçim
bicimce	biçimce
bicimde	biçimde
bicimden	biçimden
bicime	biçime
bicimi	biçimi
bicimin	biçimin
biciminde	biçiminde
bicimine	biçimine
bicimini	biçimini
bildir	bıldır
bildircin	bıldırcın
bilesen	bileşen
bilesene	bileşene
bilesim	bileşim
bilesimde	bileşimde
bilesime	bileşime
bilesimi	bileşimi
bilesimin	bileşimin
bilesiminde	bileşiminde
bilesimine	bileşimine
bilesimini	bileşimini
bilgic	bilgiç
bilgice	bilgiçe
bilgici	bilgiçi
bilgicin	bilgiçin
bilgicini	bilgiçini
bilinc	bilinç
bilince	bilinçe
bilinci	bilinçi
bilincin	bilinçin
bilincinde	bilinçinde
bilis	biliş
bilisi	bilişi
bilisin	bilişin
bilisinde	bilişinde
bilisine	bilişine
bilisini	bilişini
birlesen	birleşen
birlesene	birleşene
bisikletci	bisikletçi
bisikletciler	bisikletçiler
bisikletcilerin	bisikletçilerin
bizdik	bızdık
bocu	böcü
bole	böle
boleler	böleler
bolu	bölü
bolum	bölüm
bon	bön
bone	böne
borc	borç
borca	borça
borcun	borçun
bordur	bordür
bos	boş
boslu	boşlu
bosuna	boşuna
buk	bük
buke	büke
buken	büken
bukenin	bükenin
bulamac	bulamaç
burc	burç
burca	burça
burgac	burgaç
burgu	bürgü
burgulu	bürgülü
burgusuz	bürgüsüz
buruk	bürük
burulu	bürülü
burun	bürün
buyu	büyü
buyucu	büyücü
buyuculuk	büyücülük
buyuk	büyük
buyukluk	büyüklük
buyulu	büyülü
buz	büz
caba	çaba
cabada	çabada
cabadan	çabadan
cabalama	çabalama
cabalamadan	çabalamadan
cabalamak	çabalamak
cabalamalar	çabalamalar
cabalanma	çabalanma
cabalanmak	çabalanmak
cabalar	çabalar
cali	çalı
calili	çalılı
calilik	çalılık
calim	çalım
calisiz	çalısız
cam	çam
cama	çama
camca	çamça
camda	çamda
camdan	çamdan
camlar	çamlar
can	çan,Çan
cana	çana
canda	çanda
candan	çandan
canim	canım
canlar	çanlar
car	çar
cara	çara
carcur	çarçur
carcura	çarçura
carcurun	çarçurun
carda	çarda
cardan	çardan
carice	çariçe
caricesi	çariçesi
carlar	çarlar
cav	çav
cavlan	çavlan
cavlana	çavlana
cavlanma	çavlanma
cavlanmak	çavlanmak
cavlar	çavlar
cay	çay,Çay
caya	çaya
cayan	çayan
cayana	çayana
cayandan	çayandan
cayanlar	çayanlar
cehre	çehre
cehreci	çehreci
cehrede	çehrede
cehreden	çehreden
cehreler	çehreler
cehreleri	çehreleri
cehrelerin	çehrelerin
cehreli	çehreli
cehrelik	çehrelik
cehresi	çehresi
celebi	çelebi,Çelebi
celebice	çelebice
celebiler	çelebiler
celebilik	çelebilik
celim	çelim
celime	çelime
celimi	çelimi
cemreme	çemreme
cengel	çengel
cengelci	çengelci
cengelde	çengelde
cengelden	çengelden
cengele	çengele
cengeli	çengeli
cengelin	çengelin
cengelinde	çengelinde
cengeline	çengeline
cengelini	çengelini
cengellemek	çengellemek
cengellenmek	çengellenmek
cengeller	çengeller
cengelleri	çengelleri
cengelli	çengelli
cengelliler	çengelliler
cengi	çengi
cengiler	çengiler
cengilik	çengilik
cenk	çenk
cenkler	çenkler
cenkleri	çenkleri
cenklerin	çenklerin
cenkli	çenkli
cerci	çerçi
cerciden	çerçiden
cerciler	çerçiler
cercili	çerçili
cercilik	çerçilik
ceri	çeri
ceride	çeride
ceriden	çeriden
cevirim	çevirim
cevre	çevre
cevreler	çevreler
cevri	çevri
cevriler	çevriler
cevrilik	çevrilik
cevrim	çevrim
cevrimde	çevrimde
cevrimden	çevrimden
cevrime	çevrime
cevrimi	çevrimi
cevrimin	çevrimin
cevriminde	çevriminde
cevrimine	çevrimine
cevrimini	çevrimini
cicik	cıcık
cifte	çifte
cifteler	Çifteler
cik	cık
cil	çil
cilde	çilde
cim	çim
cima	çıma
cimada	çımada
cimadan	çımadan
cimalar	çımalar
cimci	çimci
cimde	çimde
cimden	çimden
cimdik	çimdik
cime	çime
cimi	çimi
cimin	çimin
ciminde	çiminde
cimine	çimine
cimini	çimini
cimleme	çimleme
cimlendirme	çimlendirme
cimlendirmede	çimlendirmede
cimlendirmek	çimlendirmek
cimlendirmesi	çimlendirmesi
cimlenme	çimlenme
cimlenmeden	çimlenmeden
cimlenmek	çimlenmek
cimlenmeler	çimlenmeler
cimlenmeleri	çimlenmeleri
cimlenmesi	çimlenmesi
cimler	çimler
cimleri	çimleri
cimlerin	çimlerin
cimli	çimli
cimlik	çimlik
cimsi	çimsi
cimsiz	çimsiz
cin	çın
cina	çına
cince	Çince
cinceleri	Çinceleri
cincik	cıncık
cine	Çine
cini	çini
ciniler	çiniler
cinli	Çinli
cinliler	Çinliler
cinlileri	Çinlileri
cinlilerin	Çinlilerin
cinlisi	Çinlisi
cip	çip
cipe	çipe
cipi	çipi
cipin	çipin
cipinde	çipinde
cipine	çipine
cipini	çipini
cipler	çipler
cipleri	çipleri
ciplerin	çiplerin
cipli	çipli
cipsi	çipsi
cipsiz	çipsiz
cir	çir
ciri	çiri
cis	cıs,çis,çiş
civa	cıva
civanim!	civanım!
ciyaklama	cıyaklama
ciyaklamadan	cıyaklamadan
ciyaklamak	cıyaklamak
ciyaklamalar	cıyaklamalar
ciyaklatmak	cıyaklatmak
ciz	cız
cocuklar!	çocuklar!
cop	çöp
coplu	çöplü
copluk	çöplük
copsuz	çöpsüz
corum	Çorum
coruma	Çoruma
corumda	Çorumda
corumdan	Çorumdan
corumlu	Çorumlu
corumun	Çorumun
cuk	çük
dalas	dalaş
dalasa	dalaşa
darac	daraç
demec	demeç
derc	derç
destanimsi	destanımsı
dikce	dikçe
dikec	dikeç
dikece	dikeçe
dinc	dinç
dince	dinçe
dinci	dinçi
dincin	dinçin
direnc	direnç
dirence	dirençe
direnci	dirençi
direncin	dirençin
direncinde	dirençinde
dirilti	dırıltı
dis	dış,diş
diski	dışkı
diskilik	dışkılık
dizdik	dızdık
dizis	diziş
dizisi	dizişi
dizisin	dizişin
dizisinde	dizişinde
dizisine	dizişine
dizisini	dizişini
dogma	doğma
dogmaca	doğmaca
dogmada	doğmada
dogmadan	doğmadan
dogmalar	doğmalar
dokulu	dökülü
dokum	döküm
dokuman	doküman
dokumana	dokümana
dokumanda	dokümanda
dokumandan	dokümandan
dokuntu	döküntü
dokuntulu	döküntülü
dokus	döküş
dol	döl
dolus	doluş
dolusun	doluşun
donelemek	dönelemek
donem	dönem
donemde	dönemde
donemden	dönemden
doneme	döneme
donemi	dönemi
donemin	dönemin
doneminde	döneminde
donemine	dönemine
donemini	dönemini
donemsi	dönemsi
donence	dönence
donuk	dönük
donum	dönüm
donumluk	dönümlük
dos	döş
dun	dün
durac	duraç
durtu	dürtü
duru	dürü
durulu	dürülü
durum	dürüm
durumcu	dürümcü
durumculuk	dürümcülük
duyun	düyun
duyuna	düyuna
duyundan	düyundan
duyunun	düyunun
duyurus	duyuruş
duyurusun	duyuruşun
duyus	duyuş
duyusun	duyuşun
ege	eğe
egeci	eğeci
egede	eğede
egeden	eğeden
egeleme	eğeleme
egelenme	eğelenme
egelenmek	eğelenmek
egeler	eğeler
egeleri	eğeleri
egelerin	eğelerin
egeli	eğeli
egesi	eğesi
eksi	ekşi
eksici	ekşici
ekside	ekşide
eksiden	ekşiden
eksiler	ekşiler
eksileri	ekşileri
eksilerin	ekşilerin
eksili	ekşili
eksilik	ekşilik
eksilikler	ekşilikler
eksilikleri	ekşilikleri
eksililer	ekşililer
eksilili	ekşilili
eksilisi	ekşilisi
eksime	ekşime
eksimeler	ekşimeler
eksimsi	ekşimsi
eksimsilik	ekşimsilik
eksisi	ekşisi
eksisiz	ekşisiz
elci	elçi
elcide	elçide
elciden	elçiden
elciler	elçiler
elcileri	elçileri
elcilerin	elçilerin
elcili	elçili
elcilik	elçilik
elcilikler	elçilikler
elcilikleri	elçilikleri
elciliklerin	elçiliklerin
elcim	elçim
elcime	elçime
elcimin	elçimin
elcisi	elçisi
elcisiz	elçisiz
erinc	erinç
eris	eriş
erise	erişe
erisin	erişin
eselemek	eşelemek
esik	eşik
esikler	eşikler
esikleri	eşikleri
esiklerin	eşiklerin
esikli	eşikli
esiklik	eşiklik
esiksiz	eşiksiz
esilme	eşilme
esilmek	eşilmek
esilmesi	eşilmesi
esiverme	eşiverme
eskin	eşkin
eskinde	eşkinde
eskinden	eşkinden
eskine	eşkine
eskini	eşkini
eskinin	eşkinin
eslek	eşlek
esleme	eşleme
eslemede	eşlemede
eslemeden	eşlemeden
eslemek	eşlemek
eslemeler	eşlemeler
eslemeleri	eşlemeleri
eslemeli	eşlemeli
eslemesi	eşlemesi
eslenik	eşlenik
eslenme	eşlenme
eslenmeden	eşlenmeden
eslenmek	eşlenmek
eslenmeleri	eşlenmeleri
eslenmesi	eşlenmesi
esli	eşli
eslide	eşlide
eslik	eşlik
eslikleri	eşlikleri
eslikli	eşlikli
esliksiz	eşliksiz
esliler	eşliler
eslileri	eşlileri
eslilerin	eşlilerin
eslilik	eşlilik
eslilikler	eşlilikler
eslisi	eşlisi
esme	eşme,Eşme
esmede	eşmede
esmeden	eşmeden
esmek	eşmek
esmeler	eşmeler
esmeleri	eşmeleri
esmelerin	eşmelerin
esmeli	eşmeli
esmesi	eşmesi
essiz	eşsiz
essizi	eşsizi
essizin	eşsizin
essizler	eşsizler
essizlik	eşsizlik
essizlikleri	eşsizlikleri
estirme	eştirme
estirmede	eştirmede
estirmeden	eştirmeden
estirmek	eştirmek
estirmeleri	eştirmeleri
estirmesi	eştirmesi
etkilesim	etkileşim
evc	evç
faca	faça
facada	façada
facadan	façadan
facalar	façalar
fas	faş
fasa	faşa
fasi	faşi
felc	felç
fesuphanallah	fesüphanallah
fig	fiğ
fildir	fıldır
fir	fır
fira	fıra
firkateyn	fırkateyn
firkateynci	fırkateynci
firkateynde	fırkateynde
firkateynden	fırkateynden
firkateyne	fırkateyne
firkateyni	fırkateyni
firkateynin	fırkateynin
firkateyninde	fırkateyninde
firkateynine	fırkateynine
firkateynini	fırkateynini
firkateynler	fırkateynler
firkateynleri	fırkateynleri
firkateynlerin	fırkateynlerin
firkateynli	fırkateynli
firkateynlik	fırkateynlik
firkateynsi	fırkateynsi
firkateynsiz	fırkateynsiz
fis	fiş
fitik	fıtık
florisi	florışı
fon	fön
fondu	fondü
fone	föne
fos	foş
fosa	foşa
fosurdama	foşurdama
fosurdamak	foşurdamak
fosurdatma	foşurdatma
fosurdatmak	foşurdatmak
gayri	gayrı
gazisi	gazışı
gec	geç
gece	geçe
gecek	geçek
geceler	geçeler
geceli	geçeli
gecelik	geçelik
gecen	geçen
gecende	geçende
gecenden	geçenden
gecene	geçene
geceni	geçeni
gecenin	geçenin
geceninde	geçeninde
gecenine	geçenine
gecenini	geçenini
gecer	geçer
gecesi	geçesi
gecesiz	geçesiz
geci	geçi
genc	genç,Genç
gerceklestirme	gerçekleştirme
gerceklestirmek	gerçekleştirmek
gerec	gereç
geris	geriş
gerisi	gerişi
gerisin	gerişin
gerisinde	gerişinde
gerisine	gerişine
gerisini	gerişini
gevsek	gevşek
gezegen	gezeğen
gezegenci	gezeğenci
gezegende	gezeğende
gezegenden	gezeğenden
gezegene	gezeğene
gezegeni	gezeğeni
gezegenin	gezeğenin
gezegeninde	gezeğeninde
gezegenine	gezeğenine
gezegenini	gezeğenini
gezegenler	gezeğenler
gezegenleri	gezeğenleri
gezegenlerin	gezeğenlerin
gezegenli	gezeğenli
gezegenlik	gezeğenlik
gezegensi	gezeğensi
gezegensiz	gezeğensiz
gezis	geziş
gezisi	gezişi
gezisin	gezişin
gezisinde	gezişinde
gezisine	gezişine
gezisini	gezişini
gidik	gıdık
gidim	gıdım
gir	gır
girda	gırda
girdan	gırdan
globulin	globülin
gocu	göçü
gocuk	göçük
gol	göl
golde	gölde
golden	gölden
gole	Göle
goleler	Göleler
golleme	gölleme
gollemek	göllemek
gollenme	göllenme
gollenmek	göllenmek
gollenmesi	göllenmesi
goller	göller
golleri	gölleri
gollerin	göllerin
gon	gön
gorme!	görme!
gorsel-isitsel	görsel-işitsel
gorsel-isitsela	görsel-işitsela
gorsel-isitselci	görsel-işitselci
gorsel-isitselcu	görsel-işitselcu
gorsel-isitselda	görsel-işitselda
gorsel-isitseldan	görsel-işitseldan
gorsel-isitselde	görsel-işitselde
gorsel-isitselden	görsel-işitselden
gorsel-isitsele	görsel-işitsele
gorsel-isitseli	görsel-işitseli
gorsel-isitselin	görsel-işitselin
gorsel-isitselina	görsel-işitselina
gorsel-isitselinda	görsel-işitselinda
gorsel-isitselinde	görsel-işitselinde
gorsel-isitseline	görsel-işitseline
gorsel-isitselini	görsel-işitselini
gorsel-isitselinu	görsel-işitselinu
gorsel-isitsellar	görsel-işitsellar
gorsel-isitsellari	görsel-işitsellari
gorsel-isitsellarin	görsel-işitsellarin
gorsel-isitseller	görsel-işitseller
gorsel-isitselleri	görsel-işitselleri
gorsel-isitsellerin	görsel-işitsellerin
gorsel-isitselli	görsel-işitselli
gorsel-isitsellik	görsel-işitsellik
gorsel-isitsellu	görsel-işitsellu
gorsel-isitselluk	görsel-işitselluk
gorsel-isitselsi	görsel-işitselsi
gorsel-isitselsiz	görsel-işitselsiz
gorsel-isitselsu	görsel-işitselsu
gorsel-isitselsuz	görsel-işitselsuz
gorsel-isitselun	görsel-işitselun
gostergeleri	göstergeleri
gostergesi	göstergesi
got	göt
gozum!	gözüm!
gul	gül
gulden	gülden
gulucuk	gülücük
gur	gür
gurultu	gürültü
gurultucu	gürültücü
gurultulu	gürültülü
gurultusuz	gürültüsüz
gurultusuzluk	gürültüsüzlük
gurun	Gürün
hac	haç
haca	haça
haci	hacı
haclamak	haçlamak
haclar	haçlar
hadim	hadım
hadimlik	hadımlık
hakli	haklı
haklilik	haklılık
haksiz	haksız
haksizlik	haksızlık
halac	Halaç
hali	halı
halic	haliç
halici	halıcı
halicilik	halıcılık
hallac	hallaç
hanim	hanım
hanime	hanıme
harac	haraç
harc	harç
haric	hariç
harim	harım
hasa	haşa
hasada	haşada
hasalar	haşalar
hasat	haşat
hasis	haşiş
hasise	haşişe
hasisi	haşişi
hasisin	haşişin
hasisini	haşişini
hasisleri	haşişleri
haslama	haşlama
haslamada	haşlamada
haslamadan	haşlamadan
haslamak	haşlamak
haslamalar	haşlamalar
haslanma	haşlanma
haslanmadan	haşlanmadan
haslanmak	haşlanmak
haslanmalar	haşlanmalar
haslatma	haşlatma
haslatmak	haşlatmak
havali	havalı
havli	havlı
havuc	havuç
hayvanimsi	hayvanımsı
hazir	hazır
hemsehrim!	hemşehrim!
hemsin	Hemşin
hic	hiç
hik	hık
his	hiş
hisleri	hişleri
hislerin	hişlerin
hislik	hişlik
hissiz	hişsiz
hist	hişt
histe	hişte
histi	hişti
histin	hiştin
hiz	hız
hiza	hıza
hizmetci	hizmetçi
hizmetciler	hizmetçiler
hizmetcilerin	hizmetçilerin
hopurtu	höpürtü
hot	höt
hoyratca	hoyratça
hoyuk	höyük
hucum	hücum
hucuma	hücuma
hucumda	hücumda
hucumdan	hücumdan
hucumun	hücumun
huda	Hüda
hulasa	hülasa
hulasaten	hülasaten
hulya	hülya
hulyada	hülyada
hulyadan	hülyadan
hulyalar	hülyalar
huma	Hüma
hunsa	hünsa
hunsalar	hünsalar
hur	hür
hurc	hurç
hus	huş
husu	huşu
husular	huşular
husun	hüsün
hususu	huşusu
hususuz	huşusuz
huzme	hüzme
huzmeler	hüzmeler
huzmeleri	hüzmeleri
huzmeli	hüzmeli
huzmesi	hüzmesi
ibis	ibiş
ibise	ibişe
ibisi	ibişi
ibisin	ibişin
ibisler	ibişler
ibisleri	ibişleri
ibislerin	ibişlerin
ibrani	İbrani
ibranice	İbranice
ibranicede	İbranicede
idil	İdil
idilde	İdilde
idilden	İdilden
idile	İdile
idili	İdili
idilin	İdilin
idilinde	İdilinde
idiller	İdiller
idilleri	İdilleri
idilli	İdilli
idillik	İdillik
ifsa	ifşa
ifsada	ifşada
ihlas	İhlas
ihlasa	İhlasa
ihlaslar	İhlaslar
ihrac	ihraç
ihsangazi	İhsangazi
ihsaniye	İhsaniye
ihtiyac	ihtiyaç
ikizce	İkizce
ikizcede	İkizcede
ikizceden	İkizceden
ikizdere	İkizdere
ikizler	İkizler
ikizlerde	İkizlerde
ikizlerden	İkizlerden
ikizlere	İkizlere
ikizleri	İkizleri
ikizlerin	İkizlerin
ikizlerinde	İkizlerinde
ikizlerine	İkizlerine
ikizlerini	İkizlerini
ikizlerler	İkizlerler
ikizlerlik	İkizlerlik
ilac	ilaç
ilah	İlah
ilaha	İlaha
ilahe	İlahe
ilahi	İlahi
ilahin	İlahin
ilahinde	İlahinde
ilahine	İlahine
ilahini	İlahini
ilahlar	İlahlar
ilce	ilçe
ilcede	ilçede
ilceden	ilçeden
ilceler	ilçeler
ilceleri	ilçeleri
ilcelerin	ilçelerin
ilcesi	ilçesi
ilgama	ılgama
ilgim	ılgım
ilgin	ılgın,Ilgın
ilginc	ilginç
ilik	ılık
iliklik	ılıklık
ilim	ılım
ilimli	ılımlı
ilimlilik	ılımlılık
imali	imalı
imlec	imleç
inanc	inanç
inanca	inança
inc	inç
ince	inçe
incesu	İncesu
inci	inçi
incil	İncil
incile	İncile
incili	İncili
incilin	İncilin
incilinde	İncilinde
inciline	İnciline
incilini	İncilini
incin	inçin
incinde	inçinde
incine	inçine
incini	inçini
incirliova	İncirliova
inebolu	İnebolu
inec	ineç
ingiliz	İngiliz
ingilizce	İngilizce
ingilizcede	İngilizcede
ingilizceden	İngilizceden
ingilizceleri	İngilizceleri
ingilizcesi	İngilizcesi
ingilizler	İngilizler
ingilizleri	İngilizleri
ingilizlerin	İngilizlerin
inhisar	İnhisar
inhisara	İnhisara
inhisarda	İnhisarda
inhisardan	İnhisardan
inhisarlar	İnhisarlar
inis	iniş
inisi	inişi
inisin	inişin
inisinde	inişinde
inisine	inişine
inisini	inişini
insa	inşa
insanimsi	insanımsı
ipsala	İpsala
ira	ıra
irada	ırada
irak	ırak,ırak
iranist	İranist
iranistik	İranistik
irk	ırk
irki	ırki
irkin	ırkin
irmak	ırmak
isa	İsa
isali	İsali
iscehisar	İscehisar
isevi	İsevi
isevilik	İsevilik
isi	ısı
isil	ısıl,ışıl
isin	ısın,ışın
isinim	ışınım
iska	ıska
iskandinav	İskandinav
iskandinavlar	İskandinavlar
iskenderun	İskenderun
iskilip	İskilip
iskitler	İskitler
iskitlere	İskitlere
iskota	ıskota
iskotada	ıskotada
iskotadan	ıskotadan
iskotalar	ıskotalar
islah	ıslah
islam	İslam
islami	İslami
islamisi	İslamisi
islamiyet	İslamiyet
islamlar	İslamlar
islav	İslav
islavca	İslavca
islavist	İslavist
islavistik	İslavistik
islem	işlem
isleme	işleme
islemeci	işlemeci
islemecileri	işlemecileri
islemecilik	işlemecilik
islemecisi	işlemecisi
islemede	işlemede
islemeden	işlemeden
islemek	işlemek
islemeler	işlemeler
islemeleri	işlemeleri
islemelerin	işlemelerin
islemeli	işlemeli
islemeliler	işlemeliler
islemesi	işlemesi
islenebilme	işlenebilme
islenebilmeli	işlenebilmeli
islenebilmesi	işlenebilmesi
islenme	işlenme
islenmeden	işlenmeden
islenmek	işlenmek
islenmeler	işlenmeler
islenmeleri	işlenmeleri
islenmeli	işlenmeli
islenmesi	işlenmesi
islerlik	işlerlik
isletebilmek	işletebilmek
isletilebilmek	işletilebilmek
isletilme	işletilme
isletilmeden	işletilmeden
isletilmek	işletilmek
isletilmeleri	işletilmeleri
isletilmesi	işletilmesi
isletme	işletme
isletmeci	işletmeci
isletmecide	işletmecide
isletmeciden	işletmeciden
isletmeciler	işletmeciler
isletmecileri	işletmecileri
isletmecilerin	işletmecilerin
isletmecili	işletmecili
isletmecilik	işletmecilik
isletmecisi	işletmecisi
isletmede	işletmede
isletmeden	işletmeden
isletmek	işletmek
isletmeler	işletmeler
isletmeleri	işletmeleri
isletmelerin	işletmelerin
isletmeli	işletmeli
isletmen	işletmen
isletmeni	işletmeni
isletmenin	işletmenin
isletmeninde	işletmeninde
isletmesi	işletmesi
islettirmek	işlettirmek
isleyebilme	işleyebilme
isleyebilmek	işleyebilmek
isleyebilmeleri	işleyebilmeleri
isleyebilmesi	işleyebilmesi
isli	işli
isliden	işliden
islik	işlik,ıslık
islikleri	işlikleri
islikli	ıslıklı
isliklik	işliklik
isliler	işliler
islilik	işlilik
islisi	işlisi
isloven	İsloven
ispanyol	İspanyol
ispanyolca	İspanyolca
ispanyolcada	İspanyolcada
ispanyolcadan	İspanyolcadan
ispanyollar	İspanyollar
ispir	İspir
ispirde	İspirde
ispirden	İspirden
ispire	İspire
ispiri	İspiri
ispirin	İspirin
ispirler	İspirler
ispirlerin	İspirlerin
ispirli	İspirli
israfil	İsrafil
israilli	İsrailli
israilliler	İsrailliler
israillileri	İsraillileri
israillilerin	İsraillilerin
issiz	işsiz,ıssız
issizde	işsizde
issizden	işsizden
issize	işsize
issizi	işsizi
issizin	işsizin
issizine	işsizine
issizini	işsizini
issizler	işsizler
issizleri	işsizleri
issizlerin	işsizlerin
issizlik	işsizlik,ıssızlık
issizlikleri	işsizlikleri
istanbul	İstanbul
istanbulin	İstanbulin
istanbulini	İstanbulini
istanbullu	İstanbullu
istanbullular	İstanbullular
istanbulluluk	İstanbulluluk
iste	işte
isteler	işteler
isteli	işteli
istenc	istenç
istence	istençe
istenci	istençi
istencin	istençin
istencinde	istençinde
istes	işteş
istese	işteşe
istesin	işteşin
istifa	ıstıfa
istifada	ıstıfada
istifadan	ıstıfadan
istiha	iştiha
istir	ıştır
italyan	İtalyan
italyanca	İtalyanca
italyancada	İtalyancada
italyancadan	İtalyancadan
italyanlar	İtalyanlar
itri	ıtri
ivrindi	İvrindi
iyidere	İyidere
izmir	İzmir
izmirli	İzmirli
izmirliler	İzmirliler
izmirlileri	İzmirlileri
izmirlilerin	İzmirlilerin
izmirlilik	İzmirlilik
izmit	İzmit
iznik	İznik
kacak	kaçak
kadi	kadı
kahir	kahır
kahirli	kahırlı
kalca	kalça
kalcada	kalçada
kalcadan	kalçadan
kalcalar	kalçalar
kalci	kalcı
kalim	kalım
kalin	kalın
kalip	kalıp
kalit	kalıt
kalitim	kalıtım
kalplik	kalplık
kani	kanı
kapi	kapı
karacam	karaçam
karacamda	karaçamda
karacamdan	karaçamdan
kari	karı
karili	karılı
karilik	karılık
karin	karın
karina	karına
karmasa	karmaşa
karmasalar	karmaşalar
karoca	karoça
kas	kaş,Kaş
kasa	kaşa
kasan	kaşan
kasana	kaşana
kasanda	kaşanda
kasandan	kaşandan
kasar	kaşar
kasara	kaşara
kasarlar	kaşarlar
kase	kaşe
kaseci	kaşeci
kasede	kaşede
kaseden	kaşeden
kaselemek	kaşelemek
kaseler	kaşeler
kaseleri	kaşeleri
kaselerin	kaşelerin
kaseletme	kaşeletme
kaseletmek	kaşeletmek
kaseli	kaşeli
kaselik	kaşelik
kasesi	kaşesi
kasesiz	kaşesiz
kaskol	kaşkol
kaskola	kaşkola
kaslamak	kaşlamak
kaslar	kaşlar
kati	katı
katilik	katılık
katilim	katılım
katim	katım
katli	katlı
kavsak	kavşak
kavurmac	kavurmaç
kayac	kayaç
kaysa	kayşa
kaysalar	kayşalar
kazanc	kazanç
kazanca	kazança
keles	keleş
kelesi	keleşi
kelesin	keleşin
kelesini	keleşini
kemence	kemençe
kes	keş
kese	keşe
kesen	keşen
kesende	keşende
kesene	keşene
kesenler	keşenler
kesenlik	keşenlik
kesi	keşi
kesif	keşif
kesifler	keşifler
kesifleri	keşifleri
kesiflerin	keşiflerin
kesifli	keşifli
kesiflik	keşiflik
kesifsiz	keşifsiz
kesik	keşik
kesikleme	keşikleme
kesikli	keşikli
kesiklik	keşiklik
kesin	keşin
kesinde	keşinde
kesine	keşine
kesini	keşini
keski	keşki
kesleme	keşleme
keslemek	keşlemek
kesler	keşler
kesleri	keşleri
keslerin	keşlerin
kesli	keşli
keslik	keşlik
kic	kıç
kil	kıl
kilcik	kılçık
kilcikli	kılçıklı
kilciksiz	kılçıksız
kildan	kıldan
kilik	kılık
kilikli	kılıklı
kiliksiz	kılıksız
kilis	kılış
killi	kıllı
killilik	kıllılık
kilsiz	kılsız
kimil	kımıl
kimiz	kımız
kin	kın
kinik	Kınık
kinli	kınlı
kinlilik	kınlılık
kinsiz	kınsız
kinsizlik	kınsızlık
kipti	Kıpti
kir	kır
kira	kıra
kirac	kıraç
kiran	kıran
kirana	kırana
kiranda	kıranda
kirandan	kırandan
kirci	kırcı
kircin	kırcın
kirec	kireç
kirik	kırık
kiriklik	kırıklık
kirim	kırım
kirinim	kırınım
kirlent	kırlent
kirlente	kırlente
kirlenti	kırlenti
kirlentin	kırlentin
kirlentinde	kırlentinde
kirlentine	kırlentine
kirlentini	kırlentini
kirlik	kırlık
kirpik	kırpık
kis	kış
kisi	kişi
kisiler	kişiler
kisili	kişili
kisilik	kişilik
kisilikler	kişilikler
kisilikleri	kişilikleri
kisiliklerin	kişiliklerin
kisin	kışın
kit	kıt
kita	kıta
kitlik	kıtlık
kiya	kıya
kiyi	kıyı
kiyim	kıyım
koc	koç,Koç
koca	koça
kocak	koçak
kocan	koçan
kocana	koçana
kocanda	koçanda
kocandan	koçandan
koftun	köftün
kok	kök
koklu	köklü
kokluluk	köklülük
koksu	köksü
koksuz	köksüz
koksuzluk	köksüzlük
kokus	kokuş
kokusun	kokuşun
kole	köle
komsu	komşu
komsuda	komşuda
komsudan	komşudan
komsular	komşular
komsulu	komşulu
komsuluk	komşuluk
komsuluklar	komşuluklar
komsusu	komşusu
komsusuz	komşusuz
komun	komün
konus	konuş
konusu	konuşu
konusular	konuşular
konusuluk	konuşuluk
konusun	konuşun
kopek	köpek
kopekleme	köpekleme
kopeklemek	köpeklemek
kopeklenme	köpeklenme
kopekler	köpekler
kopekleri	köpekleri
kopeklerin	köpeklerin
kopekli	köpekli
kopeklik	köpeklik
kopeklikler	köpeklikler
kopeksi	köpeksi
kopeksiz	köpeksiz
kopuk	köpük
kopuklu	köpüklü
kopuksuz	köpüksüz
kor	kör
kore	köre
koreli	köreli
korkunc	korkunç
korkus	korkuş
korkusun	korkuşun
korkutuk	körkütük
korluk	körlük
koruk	körük
koruklu	körüklü
koruksuz	körüksüz
kos	kös
kosa	koşa
kosada	koşada
kosadan	koşadan
kosalar	koşalar
kosam	koşam
kosama	koşama
kostere	köstere
kotu	kötü
kotuluk	kötülük
koy	köy
koycu	köycü
koyculuk	köycülük
koylu	köylü
koyluk	köylük
koyluluk	köylülük
koz	köz
kul	kül,kül
kulac	kulaç
kule	küle
kullu	küllü
kulluk	küllük
kulunc	kulunç
kumas	kumaş
kup	küp
kupeste	küpeşte
kupesteler	küpeşteler
kuplu	küplü
kupsuz	küpsüz
kur	kür
kura	küra
kurar	kürar
kurarlar	kürarlar
kurdan	kürdan
kurdanlar	kürdanlar
kurde	kürde
kurk	kürk
kurklu	kürklü
kursu	kürsü
kursun	kurşun
kursuna	kurşuna
kursunda	kurşunda
kursundan	kurşundan
kursunlar	kurşunlar
kursunun	kurşunun
kurt	Kürt
kurus	kuruş
kurusa	kuruşa
kurusun	kuruşun
kus	kuş,küs
kusa	kuşa
kusak	kuşak
kusaklar	kuşaklar
kusat	küşat
kusca	kuşça
kuscalar	kuşçalar
kuscu	kuşçu
kuscuda	kuşçuda
kuscular	kuşçular
kuset	kuşet
kusete	kuşete
kuseti	kuşeti
kusetin	kuşetin
kusetinde	kuşetinde
kusetler	kuşetler
kusetleri	kuşetleri
kusetlerin	kuşetlerin
kusetli	kuşetli
kusetliler	kuşetliler
kusetsiz	kuşetsiz
kusku	kuşku,küskü
kuskun	küskün
kuskunluk	küskünlük
kuskusu	kuşkusu
kuskusuz	kuşkusuz
kuslak	kuşlak
kuslar	kuşlar
kuslara	kuşlara
kuslarda	kuşlarda
kuslardan	kuşlardan
kuslarlar	kuşlarlar
kuslu	kuşlu
kusluk	kuşluk,küslük
kusluklar	kuşluklar
kuslukluk	kuşlukluk
kussu	kuşsu
kussuz	kuşsuz
kusu	küsü
kusulu	küsülü
kusum	küşüm
kusun	kuşun
kusur	küsur
kusura	küsura
kusurda	küsurda
kusurdan	küsurdan
kusurlar	küsurlar
kusurlu	küsurlu
kusurluk	küsurluk
kusurlular	küsurlular
kusursuz	küsursuz
kusurun	küsurun
kut	küt
kutlu	kütlü
kutluk	kütlük
lece	leçe
lig	lığ
liga	lığa
ligli	lığlı
linc	linç
loca	loça
locada	loçada
locadan	loçadan
localar	loçalar
log	loğ
lok	lök
lop	löp
lopur	löpür
los	loş,lös
lup	lüp
mac	maç
macuna	maçuna
malihulya	malihülya
manti	mantı
mars	marş
marsa	marşa
marslar	marşlar
marti	martı
mas	maş
masa	maşa
masada	maşada
masadan	maşadan
masala	maşala
masalama	maşalama
masalar	maşalar
maslar	maşlar
mavis	maviş
mavisi	mavişi
mavisin	mavişin
mavisinde	mavişinde
mavisine	mavişine
mavisini	mavişini
mayin	mayın
mayis	mayıs
mazi	mazı
mazilik	mazılık
mec	meç
meci	meçi
meles	meleş
melese	meleşe
melesin	meleşin
memleketci	memleketçi
memleketciler	memleketçiler
memleketcilerin	memleketçilerin
mense	menşe
menseler	menşeler
menseli	menşeli
mensur	menşur
mensura	menşura
mensurda	menşurda
mensurdan	menşurdan
mensurlar	menşurlar
mensurlu	menşurlu
mensurun	menşurun
meric	Meriç
mese	meşe
meseli	meşeli
mesesi	meşesi
mesesiz	meşesiz
mesk	meşk
meske	meşke
mih	mıh
mirac	miraç
miskal	mıskal
mizac	mizaç
mubah	mübah
mubaha	mübaha
mubayaa	mübayaa
mubayaada	mübayaada
mubayaadan	mübayaadan
mudur	müdür
muhtac	muhtaç
mul	mül
murt	mürt
mus	muş,Muş
musa	muşa
muslu	Muşlu
musluk	muşluk
musta	muşta
musun	muşun
muzaheret	müzaheret
muzaherete	müzaherete
muzahereti	müzahereti
muzaheretin	müzaheretin
muzaheretine	müzaheretine
muzaheretini	müzaheretini
muzahir	müzahir
nalca	nalça
nalcalar	nalçalar
nasi	naşi
nasip	nasıp
nasir	nasır,naşir
nasirli	nasırlı
nasirsiz	nasırsız
nazir	nazır
nazirlik	nazırlık
nemce	Nemçe
nese	neşe
neseli	neşeli
nesir	neşir
nesirci	neşirci
nesirde	neşirde
nesirden	neşirden
nesirler	neşirler
nesirleri	neşirleri
nesirlerin	neşirlerin
nesirli	neşirli
nesirlik	neşirlik
nesren	neşren
neyce	neyçe
nis	niş
nisa	nişa
nisan	nişan
nisana	nişana
nisanda	nişanda
nisandan	nişandan
nisanlamak	nişanlamak
nisanlanma	nişanlanma
nisanlanmadan	nişanlanmadan
nisanlanmak	nişanlanmak
nisanlar	nişanlar
niyetci	niyetçi
niyetciler	niyetçiler
niyetcileri	niyetçileri
niyetcilik	niyetçilik
niyetcisi	niyetçisi
nodul	nodül
obur	öbür
oburu	öbürü
ocu	öcü
odun	ödün
odunc	ödünç
oduncu	ödüncü
odunculuk	ödüncülük
odunlu	ödünlü
odunsuz	ödünsüz
odunsuzluk	ödünsüzlük
odyometre	ödyometre
ogan	Oğan
oksuz	öksüz
oksuzluk	öksüzlük
okuz	öküz
oldurucu	öldürücü
olduruculuk	öldürücülük
oldurum	öldürüm
olgun	ölgün
olgunluk	ölgünlük
olu	ölü
oluk	ölük
oluluk	ölülük
olum	ölüm
olumlu	ölümlü
olumluk	ölümlük
olumluluk	ölümlülük
olumsuz	ölümsüz
olumsuzluk	ölümsüzlük
oluverme	ölüverme
oluvermek	ölüvermek
oluvermeleri	ölüvermeleri
oluvermeli	ölüvermeli
oluvermesi	ölüvermesi
omur	ömür
omurlu	ömürlü
omurluluk	ömürlülük
omursun	ömürsün
omursuz	ömürsüz
oncu	öncü
onculuk	öncülük
onluk	önlük
opus	öpüş
orali	oralı
orgu	örgü
orgun	örgün
ork	örk
ortac	ortaç
ortaklasa	ortaklaşa
oru	örü
oruc	oruç
orucu	örücü
osur	öşür
oturu	ötürü
oturuk	ötürük
oturuklu	ötürüklü
ovali	ovalı
ovucu	övücü
ovuntu	övüntü
oynas	oynaş
oynasa	oynaşa
ozelligi	özelliği
ozellikleri	özellikleri
pabuc	pabuç
paklik	paklık
pasa	paşa
pasalar	paşalar
pastis	pastiş
pastise	pastişe
pastisi	pastişi
pes	peş
pese	peşe
pesi	peşi
pesin	peşin
pesinde	peşinde
pesinden	peşinden
pesine	peşine
pesini	peşini
pesinin	peşinin
pesininde	peşininde
pesler	peşler
pesleri	peşleri
peslerin	peşlerin
pesli	peşli
peslik	peşlik
pessiz	peşsiz
pic	piç
pice	piçe
pici	piçi
picin	piçin
picinde	piçinde
picine	piçine
picini	piçini
pir	pır
pira	pıra
pirinc	pirinç
pirpiri	pırpırı
pisi	pişi
pisici	pişici
piside	pişide
pisiden	pişiden
pisik	pişik
pisikler	pişikler
pisikleri	pişikleri
pisiklerin	pişiklerin
pisikli	pişikli
pisiler	pişiler
pisileri	pişileri
pisilerin	pişilerin
pisili	pişili
pisilik	pişilik
pisim	pişim
pisimde	pişimde
pisimden	pişimden
pisime	pişime
pisimi	pişimi
pisimin	pişimin
pisiminde	pişiminde
pisimini	pişimini
pisimsi	pişimsi
pisisi	pişisi
pisisiz	pişisiz
pist	pışt
pisti	pişti
pistiler	piştiler
pistilik	piştilik
pit	pıt
pof	pöf
porsuk	pörsük
porsukluk	pörsüklük
posu	poşu
puf	püf
pust	puşt
pusta	puşta
pustun	puştun
raki	rakı
recine	reçine
recineler	reçineler
resme	reşme
resmesi	reşmesi
role	röle
roleler	röleler
rust	rüşt
saban	şaban
sabana	şabana
sabanda	şabanda
sabandan	şabandan
sabanlar	şabanlar
sac	saç
saca	saça
saclar	saçlar
sad	şad
sada	şada
sadi	şadi
sadik	sadık
sadiklik	sadıklık
saft	şaft
safta	şafta
sag	sağ
sagun	sağun
sah	şah
saha	şaha
sahi	şahi
sahin	şahin
sahinde	şahinde
sahinden	şahinden
sahine	şahine
sahini	şahini
sahinin	şahinin
sahininde	şahininde
sahinine	şahinine
sahinini	şahinini
sahlanma	şahlanma
sahlanmak	şahlanmak
sahlar	şahlar
sahne	şahne
sahnede	şahnede
sahneden	şahneden
sahneler	şahneler
sahneleri	şahneleri
sahnelerin	şahnelerin
sahnelik	şahnelik
sahnesi	şahnesi
sahtere	şahtere
sair	şair
sairci	şairci
sairde	şairde
sairden	şairden
saire	şaire
saireler	şaireler
sairi	şairi
sairimsi	şairimsi
sairin	şairin
sairinde	şairinde
sairine	şairine
sairini	şairini
sairler	şairler
sairleri	şairleri
sairlerin	şairlerin
sairli	şairli
sairlik	şairlik
sak	şak,şak
saka	şaka
sakada	şakada
sakadan	şakadan
sakak	şakak
sakaklar	şakaklar
sakalar	şakalar
saki	şaki
sakici	şakici
sakide	şakide
sakiden	şakiden
sakiler	şakiler
sakileri	şakileri
sakilerin	şakilerin
sakili	şakili
sakilik	şakilik
sakin	sakın
sakinde	şakinde
sakine	şakine
sakini	şakini
sakinim	sakınım
sakisi	şakisi
sakit	sakıt
saklama	şaklama
saklamadan	şaklamadan
saklamak	şaklamak
saklamalar	şaklamalar
saklar	şaklar
saklatma	şaklatma
saklatmadan	şaklatmadan
saklatmak	şaklatmak
saklatmalar	şaklatmalar
saksak	şakşak
sal	şal
sala	şala
salak	şalak
salaklar	şalaklar
salca	salça
salcada	salçada
salcadan	salçadan
salcalar	salçalar
salda	şalda
saldan	şaldan
sale	şale
sali	salı,şali
salik	salık
sallak	şallak
sallar	şallar
salt	şalt
sama	şama
samalar	şamalar
saman	şaman,Şaman
samana	şamana
samanda	şamanda
samandan	şamandan
samani	Şamani
samanlar	şamanlar
samdan	şamdan
samdanlar	şamdanlar
san	şan
sana	şana
sanda	şanda
sandan	şandan
sani	sanı
sanlar	şanlar
sans	şans
sansa	şansa
sap	şap
sapa	şapa
saplak	şaplak
saplaklar	şaplaklar
saplama	şaplama
saplamak	şaplamak
saplamalar	şaplamalar
saplar	şaplar
saplatma	şaplatma
saplatmak	şaplatmak
sapsal	şapşal
sapsala	şapşala
sapsalca	şapşalca
sapsalda	şapşalda
sapsallar	şapşallar
sarac	saraç
sari	sarı
saricik	sarıcık
sarili	sarılı
sarilik	sarılık
sarilikli	sarılıklı
sarim	sarım
sarimsi	sarımsı
sarimsilik	sarımsılık
sarisin	sarışın
sark	şark,Şark
sarka	şarka
sarkac	sarkaç
sarmac	sarmaç
sarmasan	sarmaşan
sat	şat
sata	şata
sathiye	şathiye
satir	satır,şatır
satranc	satranç
savas	savaş
savsat	Şavşat
savul	şavul
savula	şavula
sayac	sayaç
sayak	şayak
sayan	şayan
sayana	şayana
sayanda	şayanda
sayandan	şayandan
sayanlar	şayanlar
sayi	sayı,şayi
sayim	sayım
sayin	sayın
saz	şaz
saza	şaza
sazda	şazda
sazdan	şazdan
sazlar	şazlar
seb	şeb
sebe	şebe
seci	seçi,şeci
secici	seçici
secicide	seçicide
seciciden	seçiciden
seciciler	seçiciler
secicileri	seçicileri
secicilerin	seçicilerin
secicilik	seçicilik
secicilikleri	seçicilikleri
secicisi	seçicisi
secide	seçide
seciden	seçiden
seciler	seçiler
secileri	seçileri
secilerin	seçilerin
secili	seçili
secilik	seçilik
secim	seçim
secimde	seçimde
secimden	seçimden
secime	seçime
secimi	seçimi
secimin	seçimin
seciminde	seçiminde
secimine	seçimine
secimini	seçimini
secisi	seçisi
sef	şef
sefi	şefi
sefine	şefine
sek	şek
seke	şeke
sekel	şekel
sekeli	şekeli
sekelin	şekelin
sekeller	şekeller
sekelli	şekelli
seker	şeker
sekerim!	şekerim!
sekerler	şekerler
sekerlik	şekerlik
sekerlikler	şekerlikler
sekerlikleri	şekerlikleri
sekil	şekil
sekilde	şekilde
sekillendirmek	şekillendirmek
sekillenme	şekillenme
sekillenmesi	şekillenmesi
sekilleri	şekilleri
seklen	şeklen
sekler	şekler
sekleri	şekleri
seklerin	şeklerin
sekli	şekli
seklik	şeklik
seklinde	şeklinde
sekline	şekline
seksi	şeksi
seksiz	şeksiz
selek	şelek
selekler	şelekler
seleklerin	şeleklerin
selvice	selviçe
sem	şem
sema	şema
semada	şemada
semadan	şemadan
semalar	şemalar
seme	şeme
semi	şemi
semin	şemin
semine	şemine
semli	şemli
sems	şems
semse	şemse
semseler	şemseler
semseli	şemseli
semsi	şemsi
semsin	şemsin
semsinde	şemsinde
semsine	şemsine
semsiye	şemsiye
semsiyeler	şemsiyeler
sen	şen
sende	şende
senden	şenden
sendikali	sendikalı
sene	şene
seni	şeni
senide	şenide
seniler	şeniler
senilik	şenilik
senin	şenin
seninde	şeninde
senine	şenine
senini	şenini
senlendirme	şenlendirme
senlendirmek	şenlendirmek
senlendirmesi	şenlendirmesi
senlenmek	şenlenmek
senler	şenler
senleri	şenleri
senlerin	şenlerin
senli	şenli
senlik	şenlik
senlikler	şenlikler
senlikleri	şenlikleri
senliklerin	şenliklerin
sensi	şensi
sensiz	şensiz
ser	şer
sera	şera
seran	şeran
serana	şerana
serc	şerç
serce	serçe
sercede	serçede
serceden	serçeden
serceler	serçeler
serceleri	serçeleri
sercelerin	serçelerin
sercesi	serçesi
serci	şerci
sercin	serçin
sercinin	serçinin
serde	şerde
serden	şerden
sergil	şergil
sergili	şergili
serha	şerha
seri	şeri
serici	şerici
seride	şeride
seriden	şeriden
serik	şerik
serikler	şerikler
serikleri	şerikleri
seriksiz	şeriksiz
seriler	şeriler
serileri	şerileri
serilerin	şerilerin
serili	şerili
serilik	şerilik
serin	şerin
serinde	şerinde
serine	şerine
serini	şerini
seris	seriş
serisi	serişi
serisin	serişin
serisine	serişine
serisini	serişini
serisiz	şerisiz
seriye	şeriye
seriyeler	şeriyeler
serler	şerler
serleri	şerleri
serlerin	şerlerin
serli	şerli
serlik	şerlik
sersiz	şersiz
ses	şeş
sese	şeşe
sesi	şeşi
sesin	şeşin
sesinde	şeşinde
sesine	şeşine
sesini	şeşini
sesler	şeşler
sesleri	şeşleri
sesli	şeşli
seslik	şeşlik
sessiz	şeşsiz
set	şet
setim	şetim
setimde	şetimde
setler	şetler
setleri	şetleri
setlerin	şetlerin
setli	şetli
sev	şev
seve	şeve
sevi	şevi
sevin	şevin
sevinc	sevinç
sevince	sevinçe
sevinci	sevinçi
sevincin	sevinçin
sevincinde	sevinçinde
sevinde	şevinde
sevine	şevine
sevini	şevini
sevk	şevk
sevke	şevke
sevki	şevki
sevkin	şevkin
sevkinde	şevkinde
sevkine	şevkine
sevkini	şevkini
sevkler	şevkler
sevkleri	şevkleri
sevklerin	şevklerin
sevkli	şevkli
sevklileri	şevklileri
sevklilik	şevklilik
sevksiz	şevksiz
sevksizlik	şevksizlik
sey	şey
seye	şeye
seyi	şeyi
sif	şif
sifat-fiil	sıfat-fiil
sifat-fiila	sıfat-fiila
sifat-fiilci	sıfat-fiilci
sifat-fiilcu	sıfat-fiilcu
sifat-fiilda	sıfat-fiilda
sifat-fiildan	sıfat-fiildan
sifat-fiilde	sıfat-fiilde
sifat-fiilden	sıfat-fiilden
sifat-fiile	sıfat-fiile
sifat-fiili	sıfat-fiili
sifat-fiilin	sıfat-fiilin
sifat-fiilina	sıfat-fiilina
sifat-fiilinda	sıfat-fiilinda
sifat-fiilinde	sıfat-fiilinde
sifat-fiiline	sıfat-fiiline
sifat-fiilini	sıfat-fiilini
sifat-fiilinu	sıfat-fiilinu
sifat-fiillar	sıfat-fiillar
sifat-fiillari	sıfat-fiillari
sifat-fiillarin	sıfat-fiillarin
sifat-fiiller	sıfat-fiiller
sifat-fiilleri	sıfat-fiilleri
sifat-fiillerin	sıfat-fiillerin
sifat-fiilli	sıfat-fiilli
sifat-fiillik	sıfat-fiillik
sifat-fiillu	sıfat-fiillu
sifat-fiilluk	sıfat-fiilluk
sifat-fiilsi	sıfat-fiilsi
sifat-fiilsiz	sıfat-fiilsiz
sifat-fiilsu	sıfat-fiilsu
sifat-fiilsuz	sıfat-fiilsuz
sifat-fiilun	sıfat-fiilun
sife	şife
sifi	şifi
sifin	şifin
sifler	şifler
sifleri	şifleri
sifli	şifli
sifon	şifon
sifona	şifona
sifoncu	şifoncu
sifonda	şifonda
sifondan	şifondan
sifonlar	şifonlar
sifonlu	şifonlu
sifonsuz	şifonsuz
sifonun	şifonun
sig	sığ
siga	sığa
sihri	sıhri
sik	sık,şık,şık
sike	şike
sikede	şikede
sikeden	şikeden
sikeler	şikeler
sikeli	şikeli
sikelik	şikelik
sikesi	şikesi
siki	sıkı
sikici	sıkıcı
sikicilik	sıkıcılık
sikilik	sıkılık
sikim	sıkım
sikinti	sıkıntı
sikintili	sıkıntılı
sikintisiz	sıkıntısız
siklet	sıklet
siklete	sıklete
sikletin	sıkletin
siklik	sıklık,şıklık
sila	sıla
sile	şile,Şile
sileler	şileler
sileli	şileli
silem	şilem
sileme	şileme
silesi	şilesi
silin	şilin
silinde	şilinde
silinden	şilinden
siline	şiline
silini	şilini
silinin	şilinin
silinine	şilinine
silinini	şilinini
silinler	şilinler
silinleri	şilinleri
silinli	şilinli
silinlik	şilinlik
silis	siliş
silise	silişe
silisi	silişi
silisin	silişin
silisine	silişine
silisini	silişini
silisler	silişler
silisleri	silişleri
siluet	silüet
siluete	silüete
silueti	silüeti
siluetin	silüetin
siluetinde	silüetinde
siluetine	silüetine
siluetini	silüetini
siluetler	silüetler
siluetleri	silüetleri
siluetlerin	silüetlerin
siluetli	silüetli
sima	sıma
simdi	şimdi
simdiler	şimdiler
simsek	şimşek
sincan	sıncan
sindi	sındı
singin	sıngın
sinik	sınık,şinik
sinir	sınır
sinirli	sınırlı
sinirlilik	sınırlılık
sinirsiz	sınırsız
sinirsizlik	sınırsızlık
sinis	siniş
sinisi	sinişi
sinisin	sinişin
sinisinde	sinişinde
sinisine	sinişine
sinisini	sinişini
sip	şıp,şip
sipa	sıpa
sir	sır,sır
sirk	şirk
sirke	şirke
sirki	şirki
sirkin	şirkin
sirkinde	şirkinde
sirkine	şirkine
sirkini	şirkini
sirkler	şirkler
sirkleri	şirkleri
sirklerin	şirklerin
sirkli	şirkli
sirksiz	şirksiz
sirt	sırt
sis	şiş
sise	şişe
siseler	şişeler
siseli	şişeli
sisi	şişi
sisin	şişin
sisinde	şişinde
sisine	şişine
sisini	şişini
sisleme	şişleme
sislemede	şişlemede
sislemek	şişlemek
sislemeli	şişlemeli
sislemesi	şişlemesi
sislenme	şişlenme
sislenmeden	şişlenmeden
sislenmek	şişlenmek
sislenmeler	şişlenmeler
sislenmesi	şişlenmesi
sisler	şişler
sisleri	şişleri
sislerin	şişlerin
sisli	Şişli
sislide	Şişlide
sisliden	Şişliden
sislik	şişlik,şişlik
sislikler	şişlikler
sislikleri	şişlikleri
sisliklerin	şişliklerin
sisliler	Şişliler
sislileri	Şişlileri
sislilerin	Şişlilerin
sislilik	Şişlilik
sislisi	Şişlisi
sissi	şişsi
sissiz	şişsiz
sist	şist
siste	şiste
sisti	şisti
sistin	şistin
siyahimsi	siyahımsı
sizi	sızı
skec	skeç
sobe	söbe
sobeler	söbeler
sobeleri	söbeleri
sobelerin	söbelerin
sobeli	söbeli
sobelik	söbelik
sobesi	söbesi
sok	şok
soka	şoka
soklar	şoklar
soklu	şoklu
sokluk	şokluk
soksuz	şoksuz
sokuk	sökük
sokum	söküm
sokun	sökün
sokuntu	söküntü
solom	sölom
soloma	söloma
solomda	sölomda
solomdan	sölomdan
solomun	sölomun
som	şom
soma	şoma
somda	şomda
somlar	şomlar
somluk	şomluk
somun	şomun
somuru	sömürü
somurucu	sömürücü
somuruculuk	sömürücülük
sonuc	sonuç
sonucun	sonuçun
sonum	sönüm
sor	sör,Şor
sorca	Şorca
sorguc	sorguç
sorlama	şorlama
sorlamak	şorlamak
sort	şort
sorta	şorta
sortun	şortun
sorus	soruş
sorusun	soruşun
sov	şov
sua	şua
subye	sübye
subyeden	sübyeden
subyeler	sübyeler
subyeli	sübyeli
subyesi	sübyesi
suc	suç
suca	suça
sucun	suçun
suluk	süluk,sülük
suluklar	süluklar
suluksuz	süluksuz
sulun	sülün
sulus	sülüs
sumen	sümen
sumenden	sümenden
sumene	sümene
sumeni	sümeni
sumenin	sümenin
sumeninde	sümeninde
sumenler	sümenler
sumenleri	sümenleri
sumenlerin	sümenlerin
sumenli	sümenli
sumsuk	sümsük
sunca	şunca
sungu	süngü
sungulu	süngülü
suphanallah	süphanallah
sura	şura
surada	şurada
suradan	şuradan
suralar	şuralar
surat	sürat
sure	süre
surec	süreç
surece	sürece
sureci	süreci
surecin	sürecin
surecler	süreçler
surecleri	süreçleri
surede	sürede
sureden	süreden
sureler	süreler
sureleri	süreleri
surelerin	sürelerin
sureli	süreli
surelide	sürelide
surelik	sürelik
sureliler	süreliler
surelilik	sürelilik
surelisi	sürelisi
suresi	süresi
suresince	süresince
suresiz	süresiz
suresize	süresize
suru	sürü
surum	sürüm
sus	süs
sut	süt,şut
sutlama	şutlama
sutlamak	şutlamak
sutlanmak	şutlanmak
sutlu	sütlü
sutluk	sütlük
sutsu	sütsü
sutsuz	sütsüz
sutsuzluk	sütsüzlük
sutun	sütun
sutunda	sütunda
sutyen	sütyen
sutyende	sütyende
sutyenden	sütyenden
sutyene	sütyene
sutyeni	sütyeni
sutyenin	sütyenin
sutyenini	sütyenini
sutyenler	sütyenler
sutyenleri	sütyenleri
sutyenlerin	sütyenlerin
sutyenli	sütyenli
sutyensiz	sütyensiz
suyu	şüyu
suyulu	şüyulu
suyum	süyüm
tac	taç
taca	taça
taki	takı
takim	takım
talas	talaş
talasa	talaşa
tapi	tapı
taraca	taraça
taras	taraş
tarasa	taraşa
tarihce	tarihçe
tarihci	tarihçi
tarihciler	tarihçiler
tarihcileri	tarihçileri
tarihcilik	tarihçilik
tarihcisi	tarihçisi
tas	taş
tasa	taşa
taslama	taşlama
taslamada	taşlamada
taslamadan	taşlamadan
taslamak	taşlamak
taslamalar	taşlamalar
taslanma	taşlanma
taslanmadan	taşlanmadan
taslanmak	taşlanmak
taslar	taşlar
taslatma	taşlatma
taslatmak	taşlatmak
taslayabilme	taşlayabilme
taslayabilmek	taşlayabilmek
taslayabilmesi	taşlayabilmesi
tasma	taşma
tasmada	taşmada
tasmadan	taşmadan
tasmalar	taşmalar
tavsan	tavşan
tavsana	tavşana
tayin	tayın
tazi	tazı
tedric	tedriç
temasa	temaşa
temasalar	temaşalar
teshir	teşhir
teshirci	teşhirci
teshirciler	teşhirciler
teshircilik	teşhircilik
teshirde	teşhirde
teshirden	teşhirden
teshire	teşhire
teshiri	teşhiri
teshirin	teşhirin
teshirinde	teşhirinde
teshirine	teşhirine
teshirini	teşhirini
teshirler	teşhirler
teshirleri	teşhirleri
teshirli	teşhirli
teshirlik	teşhirlik
tesri	teşri
tesriden	teşriden
tesriler	teşriler
tesrin	teşrin
tesrinde	teşrinde
tesrinden	teşrinden
tesrine	teşrine
tesrini	teşrini
test	teşt
teste	teşte
testi	teşti
testin	teştin
testine	teştine
testini	teştini
testler	teştler
testlerin	teştlerin
tevazun	tevazün
tik	tık
tikim	tıkım
tikiz	tıkız
tin	tın
tini	tını
tip	tıp
tir	tır
tira	tıra
tiril	tırıl
tirse	tirşe
tirseler	tirşeler
topac	topaç
tor	tör
tore	töre
tos	tös
toz	töz
tozculuk	tözcülük
trans	tranş
transa	tranşa
translar	tranşlar
tuf	tüf
tuh	tüh
tul	tül
tulde	tülde
tulden	tülden
tule	tüle
tullenmek	tüllenmek
tuller	tüller
tulleri	tülleri
tullerin	tüllerin
tulu	tülü
tum	tüm
tun	tün
tunc	tunç
tur	tür
tura	türa
turban	türban
turbana	türbana
turbanda	türbanda
turbandan	türbandan
turlu	türlü
tursu	turşu
tursuda	turşuda
tursudan	turşudan
tursular	turşular
tursulu	turşulu
tursuluk	turşuluk
tursusu	turşusu
tursusuz	turşusuz
turum	türüm
turunc	turunç
tutac	tutaç
tutsu	tütsü
tutun	tütün
tutuncu	tütüncü
tutunluk	tütünlük
ucun	uçun
ucuna	uçuna
ucunda	uçunda
ucundan	uçundan
ucunun	uçunun
ucuz	üçüz
ucuzlu	üçüzlü
ulus	ülüş
umran	ümran
umuk	ümük
unlu	ünlü
unluluk	ünlülük
unsuz	ünsüz
urun	ürün
ussak	uşşak
ust	üst
usta	üsta
ustun	üstün
usulsuz	usulsüz
usulsuzluk	usulsüzlük
utanc	utanç
utanca	utança
utangac	utangaç
utu	ütü
utucu	ütücü
utuculuk	ütücülük
utulu	ütülü
uzluk	üzlük
uzum	üzüm
uzumsu	üzümsü
uzunc	üzünç
uzuncalar	uzunçalar
varis	varış
vebali	vebalı
veche	veçhe
vecheler	veçheler
vin	vın
vinc	vinç
viz	vız
vurac	vuraç
yabanil	yabanıl
yakin	yakın
yakinlik	yakınlık
yamac	yamaç
yanki	yankı
yansak	yanşak
yaras	yaraş
yarasa	yaraşa
yarasin!	yarasın!
yardim	yardım
yari	yarı
yarim	yarım
yarin	yarın
yarinki	yarınki
yarinkiler	yarınkiler
yarinkileri	yarınkileri
yarlik	yarlık
yas	yaş
yasa	yaşa
yasada	yaşada
yasadan	yaşadan
yasalar	yaşalar
yasam	yaşam
yasama	yaşama
yasamaca	yaşamaca
yasamada	yaşamada
yasamadan	yaşamadan
yasamak	yaşamak
yasamalar	yaşamalar
yasamda	yaşamda
yasamdan	yaşamdan
yasanabilme	yaşanabilme
yasanabilmek	yaşanabilmek
yasanabilmeli	yaşanabilmeli
yasanabilmesi	yaşanabilmesi
yasanma	yaşanma
yasanmadan	yaşanmadan
yasanmak	yaşanmak
yasatabilme	yaşatabilme
yasatabilmek	yaşatabilmek
yasatabilmeli	yaşatabilmeli
yasatabilmesi	yaşatabilmesi
yasatma	yaşatma
yasatmada	yaşatmada
yasatmadan	yaşatmadan
yasatmak	yaşatmak
yasatmamak	yaşatmamak
yasayabilme	yaşayabilme
yasayabilmek	yaşayabilmek
yasayabilmeleri	yaşayabilmeleri
yasayabilmeli	yaşayabilmeli
yasayabilmesi	yaşayabilmesi
yaslanabilme	yaşlanabilme
yaslanabilmek	yaşlanabilmek
yaslanabilmeleri	yaşlanabilmeleri
yaslanabilmeli	yaşlanabilmeli
yaslanabilmesi	yaşlanabilmesi
yaslanma	yaşlanma
yaslanmada	yaşlanmada
yaslanmadan	yaşlanmadan
yaslanmak	yaşlanmak
yaslanmalar	yaşlanmalar
yaslar	yaşlar
yasmak	yaşmak
yatim	yatım
yatsi	yatsı
yavas!	yavaş!
yayin	yayın
yayli	yaylı
yengec	yengeç,Yengeç
yenilesim	yenileşim
yetismeyesi!	yetişmeyesi!
yir	yır
yirik	yırık
yog	yoğ
yoga	yoğa
yon	yön
yoruk	Yörük
yun	yün
yuru!	yürü!
zabit	zabıt
zarimsi	zarımsı
zayice	zayiçe
zevc	zevç
zevkusefa	zevküsefa
zih	zıh
ziha	zıha
zul	zül
zulal	zülal
